txHash,blockTimeUnix,changeType,ISC Balance Change,prevBalance,newBalance
3eYNXWrbRcWKTzikJdVuvwduR8V3W3baSViK57nKJHBijfocvck77uePnPiTvQdNST815pd22xxYCBNjnw21heE8,1680123809,inc,-100000,144850,44850
3STgWg7dDq5asc5iVCTW73RPW89AX4eBM8RWfd7ddZwScUBEQe1UsC5DRzWoiwnFKT7TZSnt2BuDafg9zyVTwyYC,1680123743,dec,-5000,149850,144850
5aXEaY21WU1Mtir3BrMPTg5JFp9abhbEmh26FMBLBX2jWyJWbjqRBPkHzpNkdVCG5e4GjopbXrU8grGaFdCVKVCn,1680123479,dec,-10,149860,149850
5m3PCX1Ed514jLbEdv3CGEigLDrFcjf4QifSkdvD4wHTbNekMx9m53kxgvc8fNc9cgK9YAxxVaQFPeGwbkPy7UwD,1679854593,dec,-10,149870,149860
3AcfdJViJgHz77rBj1LYxNHogN8owrD123CnEYx6BncXPhncruSXNP3QbVX7VqwtN4vhBea2vou5Fdv4ejy6tjDf,1679688018,inc,149860,10,149870
EzRAyep8KPdSxpiCQ25FcxtDzPR2jS5t13p1k7Gx5UL9JQy9A3PpiQbjhuzc8LLunGjvDEPHcbtksngyC9PH6Me,1679687936,inc,10,0,10
TKm1DQmUQYmTsEBJFSBbthAf6Emh17FQJrKQCcNCHzNLgG1QXpvFFio8bwfuEstjbvWVcYBsDU4vWmLYDzzMqeK,1679687575,dec,-1,1,0
5hUJzzdurQvT59pDVLEsAh2hMwDC4SVj9uNmwH5dzLHUrcb6YmVGq3jdZvxH68HNTYVH6HoyMAMSfN2ZuGVgZuJq,1679685878,inc,1,0,1
